1 16 1 1 25 29 18 18 18 18 18 28 27 1 1 1 1 1 16 1 1 1 16 1 16 1 16 1 16 16 16 16 16 16 16 16 16 16 16 16 16 12 10 10 10 10 10 13 16 16 
16 1 1 16 1 25 26 29 18 18 28 27 1 1 16 1 16 16 1 16 16 1 1 1 16 16 1 1 1 1 1 1 1 1 1 16 1 1 1 1 1 8 3 3 3 3 3 7 1 16 
1 16 1 1 1 1 1 25 26 26 27 1 1 16 16 1 1 16 1 1 16 1 16 1 16 16 1 1 1 1 1 1 1 1 1 16 1 1 1 1 1 8 3 3 3 3 3 7 16 1 
16 1 1 16 1 16 1 1 1 1 16 1 1 1 1 16 1 1 1 16 1 1 1 16 1 16 1 1 1 1 16 16 16 1 1 16 1 1 16 1 16 8 3 3 3 3 3 7 20 21 
1 16 1 1 1 1 1 1 1 1 1 16 1 16 1 1 1 16 1 16 16 16 16 16 1 16 1 1 1 1 16 1 16 1 1 1 1 1 1 16 16 8 3 3 3 3 3 7 23 18 
1 1 20 21 22 16 1 1 1 1 1 1 1 16 1 16 16 1 16 1 1 1 1 16 16 16 16 16 16 16 16 16 16 1 1 1 1 1 16 1 16 14 5 6 3 4 5 15 23 18 
21 21 31 18 30 22 16 1 16 1 1 1 16 1 1 16 1 16 1 16 1 16 16 1 1 16 1 16 16 1 16 1 16 16 16 16 16 16 1 16 1 16 1 8 3 7 20 21 31 18 
18 18 18 18 18 30 22 1 1 1 1 1 1 16 16 1 1 1 1 1 16 1 1 1 16 1 1 16 1 1 1 16 1 1 16 1 1 16 1 16 1 1 16 8 3 7 23 18 18 18 
26 26 29 18 18 28 27 1 16 16 1 1 1 1 1 1 16 1 16 16 1 16 16 16 16 16 1 1 16 16 16 16 16 16 1 16 1 1 16 1 16 1 1 8 3 7 23 18 18 18 
1 16 23 18 28 27 1 1 1 1 1 1 1 16 1 16 1 1 16 1 16 16 3 3 3 3 16 16 16 3 3 3 3 16 1 16 16 16 16 1 1 16 16 8 3 7 23 18 18 18 
16 1 25 26 27 1 16 1 16 1 16 1 1 16 1 1 1 16 16 1 16 3 3 1 1 3 3 16 3 3 1 1 3 3 16 16 1 16 16 16 16 1 16 8 3 7 25 29 18 18 
1 1 1 1 1 16 1 16 1 1 1 1 16 16 1 1 16 1 1 16 3 3 1 20 22 1 3 3 3 1 20 22 1 3 3 1 16 1 16 1 1 16 1 8 3 7 1 23 18 18 
1 16 16 1 16 1 1 1 1 1 16 16 1 1 1 16 1 16 16 3 3 1 20 18 18 22 1 3 1 20 18 18 22 1 3 3 16 16 16 16 1 1 1 8 3 7 16 25 29 18 
1 1 16 16 1 1 16 16 1 1 1 16 1 1 16 1 16 1 3 3 1 20 18 18 18 18 22 1 20 18 18 19 18 22 1 3 3 1 16 16 16 16 1 8 3 7 16 1 23 18 
1 16 1 1 16 16 1 1 1 1 1 1 16 1 1 1 1 16 3 1 1 23 18 19 18 18 18 21 18 18 19 18 18 24 1 1 3 16 16 1 1 1 16 8 3 7 1 1 25 29 
16 1 1 16 1 1 1 16 1 1 16 16 1 1 1 16 16 16 3 1 1 23 18 18 18 18 19 18 18 18 18 18 18 24 1 1 3 16 1 1 16 1 1 8 3 7 1 16 1 23 
1 16 12 10 10 10 13 1 1 1 16 1 16 1 16 1 1 16 3 1 1 23 18 18 19 18 18 18 18 18 19 18 18 24 1 1 3 1 16 1 16 1 16 8 3 7 1 1 1 23 
1 1 8 3 3 3 9 10 13 12 10 13 16 1 16 1 16 16 3 3 1 1 25 18 18 18 18 19 18 18 18 18 27 1 1 3 3 16 16 1 1 1 1 8 3 7 16 1 1 23 
16 1 8 3 3 3 3 3 3 3 3 7 1 16 1 16 1 16 16 3 3 1 1 25 18 18 18 18 18 19 18 27 1 1 3 3 16 1 1 16 16 1 16 8 3 7 1 16 1 25 
1 1 8 3 3 3 4 5 5 6 3 7 1 16 1 1 1 1 16 16 3 3 1 1 25 18 19 18 18 18 27 1 1 3 3 16 16 16 16 1 1 16 1 8 3 7 1 1 1 1 
1 16 8 3 3 3 7 16 1 8 3 7 16 1 16 16 1 16 1 16 16 3 3 1 1 25 18 18 18 27 1 1 3 3 16 1 1 16 16 16 1 16 1 8 3 7 16 16 16 16 
1 16 14 5 5 5 15 1 16 8 3 7 1 1 1 1 16 16 16 1 16 16 3 3 1 1 25 18 27 1 1 3 3 1 16 16 16 1 16 1 16 16 1 8 3 7 16 16 16 16 
1 1 1 16 1 1 1 1 1 8 3 7 16 16 1 16 1 1 16 16 1 16 1 3 3 1 1 26 1 1 3 3 16 1 1 1 16 16 1 1 16 1 1 8 3 7 16 16 16 16 
16 1 1 1 16 1 16 1 16 8 3 7 1 1 16 1 16 16 1 16 1 16 1 16 3 3 1 1 1 3 3 1 1 16 1 16 1 16 16 1 1 16 1 8 3 7 16 16 16 16 
1 16 1 1 1 1 1 16 1 8 3 7 16 1 1 16 1 1 16 1 16 16 16 16 16 3 3 3 3 3 16 16 1 1 16 1 16 1 1 1 16 1 16 8 3 7 16 16 16 16 
1 1 1 16 16 16 1 1 1 8 3 7 16 1 16 1 1 16 16 16 16 16 1 1 16 6 3 3 3 4 16 1 16 1 1 16 16 16 16 1 16 16 1 8 3 7 16 16 16 16 
16 1 1 1 16 16 1 16 1 8 3 9 10 10 10 10 10 10 10 10 10 10 10 10 10 11 3 3 3 9 10 10 10 10 10 10 10 10 10 10 10 10 10 11 3 7 16 16 16 16 
1 1 16 1 16 1 16 1 16 8 3 3 3 3 3 3 3 3 3 3 3 3 3 3 3 3 3 3 3 3 3 3 3 3 3 3 3 3 3 3 3 3 3 3 3 7 16 16 16 16 
1 1 1 16 1 16 1 16 1 8 3 4 5 5 5 5 5 5 5 5 5 5 5 6 3 3 3 3 3 3 3 4 5 5 5 5 5 5 5 5 5 5 5 5 3 7 16 16 16 16 
1 16 16 1 16 1 1 1 16 8 3 7 1 16 1 16 16 1 20 21 21 21 22 8 3 3 3 3 3 3 3 7 20 21 21 21 22 1 16 16 1 16 16 8 3 7 16 16 16 16 
16 1 1 16 1 1 16 1 16 8 3 7 1 16 1 16 1 1 23 19 18 18 24 8 3 3 3 3 3 3 3 7 23 18 18 19 24 1 16 1 1 1 16 8 3 7 16 16 16 16 
21 21 21 21 21 21 21 21 21 21 34 21 21 21 22 1 16 1 23 18 18 19 24 8 3 3 3 3 3 3 3 7 23 19 18 18 24 1 1 1 16 16 1 8 3 7 16 16 16 16 
18 18 18 18 18 18 18 18 18 18 34 18 18 18 30 22 1 1 25 26 26 26 27 14 5 5 5 5 5 5 5 15 25 26 26 26 27 16 1 16 1 16 16 8 3 7 16 16 16 16 
18 18 18 18 18 18 18 18 18 18 34 18 18 18 18 24 1 16 16 1 1 1 1 16 16 1 1 16 1 1 1 1 1 1 1 1 1 1 16 16 1 16 16 8 3 7 16 16 16 16 
26 26 26 26 26 26 26 26 26 26 34 26 26 29 18 30 22 1 1 1 16 16 16 1 1 16 16 1 1 16 1 16 16 1 16 16 1 16 16 1 16 16 1 8 3 7 16 16 16 16 
1 16 1 16 1 1 16 16 1 8 3 7 16 25 29 18 24 1 16 1 1 16 1 16 16 16 1 16 16 16 16 1 1 16 1 16 16 16 16 16 16 1 1 8 3 7 16 16 16 16 
16 1 1 1 16 1 1 1 16 8 3 7 16 1 23 18 30 22 1 16 16 1 16 1 16 16 1 1 16 1 16 1 16 16 16 16 16 1 16 16 16 1 1 8 3 7 16 16 16 16 
16 1 16 1 16 16 16 1 1 8 3 7 1 1 23 18 18 24 1 1 16 16 1 16 1 16 16 1 16 16 1 1 16 16 16 16 16 20 22 1 16 16 16 8 3 7 16 16 16 16 
1 1 1 1 1 16 1 1 16 8 3 7 1 1 23 18 18 24 16 1 1 1 1 16 16 1 16 16 16 16 16 16 16 16 16 1 20 31 30 22 16 16 16 8 3 7 16 16 16 16 
1 16 1 12 10 10 10 10 10 11 3 7 16 16 23 18 18 24 1 16 16 16 16 16 1 16 16 16 16 1 16 16 1 20 21 21 31 18 28 27 16 1 16 8 3 7 16 16 16 16 
1 1 1 8 3 3 3 3 3 3 3 7 1 1 23 18 18 24 16 1 16 16 16 16 16 16 16 1 16 16 1 1 16 25 18 18 18 28 27 16 16 16 16 8 3 7 16 16 16 16 
16 1 16 8 3 4 5 5 5 5 5 15 1 1 23 18 18 24 1 1 1 16 1 16 1 16 16 1 16 16 16 16 16 16 25 26 26 27 16 16 1 16 16 8 3 7 16 16 16 16 
1 1 1 8 3 7 1 1 16 1 1 1 16 1 23 18 18 24 16 16 1 1 16 1 16 1 16 16 16 16 16 1 16 1 1 16 16 16 16 16 1 16 16 8 3 7 16 16 16 16 
16 1 16 8 3 7 1 16 1 16 1 16 1 1 23 18 18 24 16 16 16 16 16 1 1 1 1 16 16 1 16 16 16 1 16 16 16 1 16 12 10 10 10 16 3 16 10 10 13 16 
12 10 10 11 3 9 10 10 13 1 16 16 16 1 23 18 18 24 16 16 1 1 16 1 1 16 1 16 16 16 1 16 16 16 16 1 16 1 1 8 3 3 3 3 3 3 3 3 7 16 
8 3 3 3 3 3 3 3 7 1 1 1 1 16 23 18 18 24 1 1 16 16 1 16 16 1 1 1 16 17 17 17 17 16 1 1 16 16 16 8 3 3 3 3 3 3 3 3 7 16 
8 3 3 3 3 3 3 3 7 16 1 16 1 1 23 18 18 24 16 16 16 16 16 1 1 1 16 16 16 17 17 17 17 16 16 16 16 1 16 8 3 3 3 3 3 3 3 3 7 16 
8 3 3 3 3 3 3 3 7 16 1 1 16 1 23 18 18 24 1 1 16 1 1 16 16 1 1 16 1 17 17 17 17 17 17 17 17 17 17 8 3 3 3 3 3 3 3 3 7 16 
14 5 5 5 5 5 5 5 15 16 1 16 1 16 23 18 18 24 16 16 1 1 16 16 16 1 16 16 16 17 17 17 17 16 1 16 16 16 16 8 3 3 3 3 3 3 3 3 7 16 
16 1 16 1 16 1 1 16 1 1 1 1 1 16 23 18 18 24 1 16 1 16 1 1 16 16 1 16 16 16 16 16 16 16 16 16 16 16 16 14 5 5 5 5 5 5 5 5 16 16 
